/	geekshop.views.index	index
/__debug__/render_panel/	debug_toolbar.views.render_panel	djdt:render_panel
/__debug__/sql_explain/	debug_toolbar.panels.sql.views.sql_explain	djdt:sql_explain
/__debug__/sql_profile/	debug_toolbar.panels.sql.views.sql_profile	djdt:sql_profile
/__debug__/sql_select/	debug_toolbar.panels.sql.views.sql_select	djdt:sql_select
/__debug__/template_source/	debug_toolbar.panels.templates.views.template_source	djdt:template_source
/admin/categories/create/	adminapp.views.category_create	myadmin:category_create
/admin/categories/delete/<int:pk>/	adminapp.views.category_delete	myadmin:category_delete
/admin/categories/read/	adminapp.views.categories	myadmin:categories
/admin/categories/update/<int:pk>/	adminapp.views.category_update	myadmin:category_update
/admin/products/create/category/<int:pk>/	adminapp.views.product_create	myadmin:product_create
/admin/products/delete/<int:pk>/	adminapp.views.product_delete	myadmin:product_delete
/admin/products/read/<int:pk>/	adminapp.views.product_read	myadmin:product_read
/admin/products/read/category/<int:pk>/	adminapp.views.products	myadmin:products
/admin/products/update/<int:pk>/	adminapp.views.product_update	myadmin:product_update
/admin/users/create/	adminapp.views.user_create	myadmin:user_create
/admin/users/delete/<int:pk>/	adminapp.views.user_delete	myadmin:user_delete
/admin/users/read/	adminapp.views.users	myadmin:users
/admin/users/update/<int:pk>/	adminapp.views.user_update	myadmin:user_update
/auth/edit/	authapp.views.edit	auth:edit
/auth/login/	authapp.views.login	auth:login
/auth/logout/	authapp.views.logout	auth:logout
/auth/media/<path>	django.views.static.serve
/auth/register/	authapp.views.register	auth:register
/auth/verify/<str:email>/<str:activation_key>/	authapp.views.verify	auth:verify
/basket/	basketapp.views.basket	basket:view
/basket/add/<int:pk>/	basketapp.views.basket_add	basket:add
/basket/edit/<int:pk>/<int:quantity>/	basketapp.views.basket_edit	basket:edit
/basket/remove/<int:pk>/	basketapp.views.basket_remove	basket:remove
/complete/<str:backend>/	social_django.views.complete	social:complete
/contacts/	geekshop.views.contacts	contacts
/disconnect/<str:backend>/	social_django.views.disconnect	social:disconnect
/disconnect/<str:backend>/<int:association_id>/	social_django.views.disconnect	social:disconnect_individual
/django-admin/	django.contrib.admin.sites.index	admin:index
/django-admin/<app_label>/	django.contrib.admin.sites.app_index	admin:app_list
/django-admin/<url>	django.contrib.admin.sites.catch_all_view
/django-admin/auth/group/	django.contrib.admin.options.changelist_view	admin:auth_group_changelist
/django-admin/auth/group/<path:object_id>/	django.views.generic.base.view
/django-admin/auth/group/<path:object_id>/change/	django.contrib.admin.options.change_view	admin:auth_group_change
/django-admin/auth/group/<path:object_id>/delete/	django.contrib.admin.options.delete_view	admin:auth_group_delete
/django-admin/auth/group/<path:object_id>/history/	django.contrib.admin.options.history_view	admin:auth_group_history
/django-admin/auth/group/add/	django.contrib.admin.options.add_view	admin:auth_group_add
/django-admin/authapp/shopuser/	django.contrib.admin.options.changelist_view	admin:authapp_shopuser_changelist
/django-admin/authapp/shopuser/<path:object_id>/	django.views.generic.base.view
/django-admin/authapp/shopuser/<path:object_id>/change/	django.contrib.admin.options.change_view	admin:authapp_shopuser_change
/django-admin/authapp/shopuser/<path:object_id>/delete/	django.contrib.admin.options.delete_view	admin:authapp_shopuser_delete
/django-admin/authapp/shopuser/<path:object_id>/history/	django.contrib.admin.options.history_view	admin:authapp_shopuser_history
/django-admin/authapp/shopuser/add/	django.contrib.admin.options.add_view	admin:authapp_shopuser_add
/django-admin/autocomplete/	django.contrib.admin.sites.autocomplete_view	admin:autocomplete
/django-admin/jsi18n/	django.contrib.admin.sites.i18n_javascript	admin:jsi18n
/django-admin/login/	django.contrib.admin.sites.login	admin:login
/django-admin/logout/	django.contrib.admin.sites.logout	admin:logout
/django-admin/mainapp/product/	django.contrib.admin.options.changelist_view	admin:mainapp_product_changelist
/django-admin/mainapp/product/<path:object_id>/	django.views.generic.base.view
/django-admin/mainapp/product/<path:object_id>/change/	django.contrib.admin.options.change_view	admin:mainapp_product_change
/django-admin/mainapp/product/<path:object_id>/delete/	django.contrib.admin.options.delete_view	admin:mainapp_product_delete
/django-admin/mainapp/product/<path:object_id>/history/	django.contrib.admin.options.history_view	admin:mainapp_product_history
/django-admin/mainapp/product/add/	django.contrib.admin.options.add_view	admin:mainapp_product_add
/django-admin/mainapp/productcategory/	django.contrib.admin.options.changelist_view	admin:mainapp_productcategory_changelist
/django-admin/mainapp/productcategory/<path:object_id>/	django.views.generic.base.view
/django-admin/mainapp/productcategory/<path:object_id>/change/	django.contrib.admin.options.change_view	admin:mainapp_productcategory_change
/django-admin/mainapp/productcategory/<path:object_id>/delete/	django.contrib.admin.options.delete_view	admin:mainapp_productcategory_delete
/django-admin/mainapp/productcategory/<path:object_id>/history/	django.contrib.admin.options.history_view	admin:mainapp_productcategory_history
/django-admin/mainapp/productcategory/add/	django.contrib.admin.options.add_view	admin:mainapp_productcategory_add
/django-admin/password_change/	django.contrib.admin.sites.password_change	admin:password_change
/django-admin/password_change/done/	django.contrib.admin.sites.password_change_done	admin:password_change_done
/django-admin/r/<int:content_type_id>/<path:object_id>/	django.contrib.contenttypes.views.shortcut	admin:view_on_site
/django-admin/social_django/association/	django.contrib.admin.options.changelist_view	admin:social_django_association_changelist
/django-admin/social_django/association/<path:object_id>/	django.views.generic.base.view
/django-admin/social_django/association/<path:object_id>/change/	django.contrib.admin.options.change_view	admin:social_django_association_change
/django-admin/social_django/association/<path:object_id>/delete/	django.contrib.admin.options.delete_view	admin:social_django_association_delete
/django-admin/social_django/association/<path:object_id>/history/	django.contrib.admin.options.history_view	admin:social_django_association_history
/django-admin/social_django/association/add/	django.contrib.admin.options.add_view	admin:social_django_association_add
/django-admin/social_django/nonce/	django.contrib.admin.options.changelist_view	admin:social_django_nonce_changelist
/django-admin/social_django/nonce/<path:object_id>/	django.views.generic.base.view
/django-admin/social_django/nonce/<path:object_id>/change/	django.contrib.admin.options.change_view	admin:social_django_nonce_change
/django-admin/social_django/nonce/<path:object_id>/delete/	django.contrib.admin.options.delete_view	admin:social_django_nonce_delete
/django-admin/social_django/nonce/<path:object_id>/history/	django.contrib.admin.options.history_view	admin:social_django_nonce_history
/django-admin/social_django/nonce/add/	django.contrib.admin.options.add_view	admin:social_django_nonce_add
/django-admin/social_django/usersocialauth/	django.contrib.admin.options.changelist_view	admin:social_django_usersocialauth_changelist
/django-admin/social_django/usersocialauth/<path:object_id>/	django.views.generic.base.view
/django-admin/social_django/usersocialauth/<path:object_id>/change/	django.contrib.admin.options.change_view	admin:social_django_usersocialauth_change
/django-admin/social_django/usersocialauth/<path:object_id>/delete/	django.contrib.admin.options.delete_view	admin:social_django_usersocialauth_delete
/django-admin/social_django/usersocialauth/<path:object_id>/history/	django.contrib.admin.options.history_view	admin:social_django_usersocialauth_history
/django-admin/social_django/usersocialauth/add/	django.contrib.admin.options.add_view	admin:social_django_usersocialauth_add
/login/<str:backend>/	social_django.views.auth	social:begin
/media/<path>	django.views.static.serve
/orders/	ordersapp.views.view	orders:orders_list
/orders/create/	ordersapp.views.view	orders:order_create
/orders/delete/<int:pk>/	ordersapp.views.view	orders:order_delete
/orders/forming/complete/<int:pk>/	ordersapp.views.order_forming_complete	orders:order_forming_complete
/orders/read/<int:pk>/	ordersapp.views.view	orders:order_read
/orders/update/<int:pk>/	ordersapp.views.view	orders:order_update
/products/	mainapp.views.products	products:index
/products/<int:pk>/	mainapp.views.products	products:category
/products/<int:pk>/page/<int:page>/	mainapp.views.products	products:page
/products/media/<path>	django.views.static.serve
/products/product/<int:pk>/	mainapp.views.product	products:product
/products/product/price/<int:pk>/	mainapp.views.get_product_price	products:get_price
